sample1	/lustre1/g/aos_shihuang/Strain2b/src/github/strain2bfunc/data/20_Staphylococcus_samples_simulation_2bRAD_result/enzyme_result/sample1.BcgI.fa.gz
sample2	/lustre1/g/aos_shihuang/Strain2b/src/github/strain2bfunc/data/20_Staphylococcus_samples_simulation_2bRAD_result/enzyme_result/sample2.BcgI.fa.gz
sample3	/lustre1/g/aos_shihuang/Strain2b/src/github/strain2bfunc/data/20_Staphylococcus_samples_simulation_2bRAD_result/enzyme_result/sample3.BcgI.fa.gz
sample4	/lustre1/g/aos_shihuang/Strain2b/src/github/strain2bfunc/data/20_Staphylococcus_samples_simulation_2bRAD_result/enzyme_result/sample4.BcgI.fa.gz
sample5	/lustre1/g/aos_shihuang/Strain2b/src/github/strain2bfunc/data/20_Staphylococcus_samples_simulation_2bRAD_result/enzyme_result/sample5.BcgI.fa.gz
sample6	/lustre1/g/aos_shihuang/Strain2b/src/github/strain2bfunc/data/20_Staphylococcus_samples_simulation_2bRAD_result/enzyme_result/sample6.BcgI.fa.gz
sample7	/lustre1/g/aos_shihuang/Strain2b/src/github/strain2bfunc/data/20_Staphylococcus_samples_simulation_2bRAD_result/enzyme_result/sample7.BcgI.fa.gz
sample8	/lustre1/g/aos_shihuang/Strain2b/src/github/strain2bfunc/data/20_Staphylococcus_samples_simulation_2bRAD_result/enzyme_result/sample8.BcgI.fa.gz
sample9	/lustre1/g/aos_shihuang/Strain2b/src/github/strain2bfunc/data/20_Staphylococcus_samples_simulation_2bRAD_result/enzyme_result/sample9.BcgI.fa.gz
sample10	/lustre1/g/aos_shihuang/Strain2b/src/github/strain2bfunc/data/20_Staphylococcus_samples_simulation_2bRAD_result/enzyme_result/sample10.BcgI.fa.gz
sample11	/lustre1/g/aos_shihuang/Strain2b/src/github/strain2bfunc/data/20_Staphylococcus_samples_simulation_2bRAD_result/enzyme_result/sample11.BcgI.fa.gz
sample12	/lustre1/g/aos_shihuang/Strain2b/src/github/strain2bfunc/data/20_Staphylococcus_samples_simulation_2bRAD_result/enzyme_result/sample12.BcgI.fa.gz
sample13	/lustre1/g/aos_shihuang/Strain2b/src/github/strain2bfunc/data/20_Staphylococcus_samples_simulation_2bRAD_result/enzyme_result/sample13.BcgI.fa.gz
sample14	/lustre1/g/aos_shihuang/Strain2b/src/github/strain2bfunc/data/20_Staphylococcus_samples_simulation_2bRAD_result/enzyme_result/sample14.BcgI.fa.gz
sample15	/lustre1/g/aos_shihuang/Strain2b/src/github/strain2bfunc/data/20_Staphylococcus_samples_simulation_2bRAD_result/enzyme_result/sample15.BcgI.fa.gz
sample16	/lustre1/g/aos_shihuang/Strain2b/src/github/strain2bfunc/data/20_Staphylococcus_samples_simulation_2bRAD_result/enzyme_result/sample16.BcgI.fa.gz
sample17	/lustre1/g/aos_shihuang/Strain2b/src/github/strain2bfunc/data/20_Staphylococcus_samples_simulation_2bRAD_result/enzyme_result/sample17.BcgI.fa.gz
sample18	/lustre1/g/aos_shihuang/Strain2b/src/github/strain2bfunc/data/20_Staphylococcus_samples_simulation_2bRAD_result/enzyme_result/sample18.BcgI.fa.gz
sample19	/lustre1/g/aos_shihuang/Strain2b/src/github/strain2bfunc/data/20_Staphylococcus_samples_simulation_2bRAD_result/enzyme_result/sample19.BcgI.fa.gz
sample20	/lustre1/g/aos_shihuang/Strain2b/src/github/strain2bfunc/data/20_Staphylococcus_samples_simulation_2bRAD_result/enzyme_result/sample20.BcgI.fa.gz
